tilesetIso.png 7 57 114
15 15
1	1	3	3	3	3	3	3	3	3	3	3	3	3	3
1	1	1	1	1	1	1	1	1	1	1	1	1	1	3
3	1	1	1	1	1	1	1	1	1	1	1	1	1	3
3	1	1	1	1	1	1	1	1	1	1	1	1	1	3
3	1	1	1	1	1	1	1	1	1	1	1	1	1	3
3	1	1	1	1	1	1	1	1	1	1	1	1	1	3
3	3	3	3	3	3	3	3	3	1	1	1	1	1	3
3	3	3	3	3	3	3	3	3	1	1	1	1	1	3
3	1	1	1	1	1	1	1	1	1	1	1	1	1	3
3	1	1	1	1	1	1	1	1	1	1	1	1	1	3
3	1	1	1	1	1	1	1	1	1	1	1	1	1	3
3	1	1	1	1	1	1	1	1	1	1	1	1	1	3
3	1	1	1	1	1	1	1	1	1	1	1	1	1	3
3	1	1	1	1	1	1	1	1	1	1	1	1	1	3
3	3	3	3	3	3	3	3	3	3	3	3	3	3	3