tilesetIso.png 7 57 114
10 10
1	1	3	3	3	3	3	3	3	3
1	1	1	1	1	1	1	1	1	3
3	1	1	1	1	1	1	1	1	3
3	3	3	3	3	1	1	1	1	3
3	1	1	1	3	1	1	1	1	3
3	1	1	1	3	3	3	1	1	3
3	1	1	1	1	1	1	1	1	3
3	1	1	1	1	1	1	1	1	3
3	1	1	1	1	1	1	1	1	3
3	3	3	3	3	3	3	3	3	3