tilesetIso.png 7 57 114
10 10
4	4	4	4	4	4	4	4	4	4
4	1	1	1	1	1	1	1	1	4
4	4	1	1	1	1	1	1	1	4
4	4	1	1	1	1	1	1	1	4
4	4	1	1	1	1	1	1	1	4
4	1	1	1	1	1	1	1	1	4
4	1	1	1	1	1	1	1	4	4
4	4	1	1	1	1	1	1	4	4
4	4	1	1	1	1	1	1	4	4
4	4	4	4	4	4	4	4	4	4